#CHR	POS	Count_A	Count_C	Count_G	Count_T	Good_depth	GENOTYPE
1	65885569	0	0	23	0	23	GG
1	74941293	42	0	0	0	42	AA
1	84722670	26	27	0	0	53	AC
1	95633977	0	0	18	23	41	GT
1	169676486	0	0	45	0	45	GG
1	171794908	0	0	0	53	53	TT
1	237048500	26	0	25	0	51	AG
1	240492734	26	0	25	0	51	AG
10	83757199	0	0	42	0	42	GG
10	106022789	21	18	0	0	39	AC
10	106039185	19	0	17	0	36	AG
10	117612248	28	0	24	0	52	AG
11	17408630	0	0	0	21	21	TT
11	60878662	1	30	0	1	32	CC
11	122713810	43	0	0	0	43	AA
12	998365	0	0	25	16	41	GT
12	12161541	39	0	0	0	39	AA
12	54466095	21	0	24	0	45	AG
12	103772777	19	0	18	0	37	AG
12	109937534	18	0	18	0	36	AG
13	23732199	0	38	0	0	38	CC
13	47505170	0	0	0	24	24	TT
13	63071787	0	41	0	0	41	CC
13	86230913	22	0	17	0	39	AG
13	110818598	0	0	0	42	42	TT
14	34195326	1	31	0	0	32	CC
14	54123959	0	15	1	21	37	CT
14	85125287	0	0	37	0	37	GG
14	97239216	0	21	0	17	38	CT
15	52027777	0	55	0	0	55	CC
15	79696701	0	40	0	0	40	CC
15	86123988	27	0	19	0	46	AG
15	86124555	17	0	19	0	36	AG
16	9654056	0	31	0	0	31	CC
17	3480447	0	12	0	11	23	CT
17	28731415	41	0	0	0	41	AA
18	8080357	19	22	0	0	41	AC
18	21495483	0	50	0	0	50	CC
18	23877175	0	37	0	0	37	CC
18	60027241	0	0	0	42	42	TT
19	8968549	25	25	0	0	50	AC
19	20741589	48	0	0	0	48	AA
19	31078219	12	0	31	0	43	AG
19	41869392	0	33	0	0	33	CC
19	51315824	0	0	29	0	29	GG
19	57739247	55	0	0	0	55	AA
2	9796791	32	0	0	0	32	AA
2	49189921	0	0	0	53	53	TT
2	68166080	26	0	27	0	53	AG
2	179871172	25	0	20	0	45	AG
2	182543455	0	26	0	0	26	CC
2	211060050	0	0	0	36	36	TT
2	234601669	0	0	20	22	42	GT
20	4312153	0	0	56	0	56	GG
20	23347553	0	28	0	30	58	CT
20	39797465	0	0	0	29	29	TT
20	40884676	0	22	0	36	58	CT
20	52951047	17	0	28	0	45	AG
21	19842577	0	37	0	0	37	CC
21	43718483	0	0	43	0	43	GG
3	59736584	0	46	0	0	46	CC
3	68434603	0	0	48	0	48	GG
3	80549257	24	0	30	0	54	AG
3	117800545	0	0	23	26	49	GT
3	160534225	0	0	31	0	31	GG
3	183818416	0	0	33	0	33	GG
4	38776491	0	0	27	33	60	GT
4	53219120	0	0	1	46	47	TT
4	60833758	24	0	20	0	44	AG
4	78270033	20	0	12	0	32	AG
4	138313566	0	0	47	0	47	GG
5	8828383	0	16	11	0	27	CG
5	16784873	0	0	0	27	27	TT
5	90151589	0	0	67	0	67	GG
5	112364945	0	0	52	0	52	GG
5	129194264	24	0	23	0	47	AG
6	47708431	50	0	0	0	50	AA
6	159425707	0	0	0	48	48	TT
6	165557550	22	0	19	0	41	AG
7	24213356	0	33	0	22	55	CT
7	45932669	18	0	17	0	35	AG
7	90773196	0	0	1	53	54	TT
8	12957475	0	36	0	0	36	CC
8	23060256	0	10	0	11	21	CT
8	31445496	32	0	28	0	60	AG
8	75822851	39	0	0	0	39	AA
8	77819857	37	0	0	0	37	AA
8	130459412	0	18	0	27	45	CT
9	26531692	25	21	0	0	46	AC
9	32516864	46	0	0	0	46	AA
9	78831415	20	1	25	0	46	AG
9	137828650	0	0	42	0	42	GG
