#CHR	POS	Count_A	Count_C	Count_G	Count_T	Good_depth	GENOTYPE
1	65885569	0	0	21	0	21	GG
1	74941293	37	0	0	0	37	AA
1	84722670	37	14	0	0	51	AC
1	95633977	0	0	0	44	44	TT
1	169676486	0	0	70	0	70	GG
1	171794908	0	0	0	85	85	TT
1	237048500	0	0	59	0	59	GG
1	240492734	0	0	74	0	74	GG
10	83757199	0	0	40	0	40	GG
10	106022789	0	25	0	0	25	CC
10	106039185	13	0	0	0	13	AA
10	117612248	0	0	31	0	31	GG
11	17408630	0	0	0	26	26	TT
11	60878662	0	49	0	0	49	CC
11	122713810	39	0	0	0	39	AA
12	998365	0	0	20	30	50	GT
12	12161541	31	0	0	0	31	AA
12	54466095	21	0	27	0	48	AG
12	103772777	21	0	31	0	52	AG
12	109937534	26	0	11	0	37	AG
13	23732199	0	64	0	0	64	CC
13	47505170	0	0	0	54	54	TT
13	63071787	0	53	0	0	53	CC
13	86230913	28	0	31	0	59	AG
13	110818598	0	1	0	46	47	TT
14	34195326	0	52	0	0	52	CC
14	54123959	0	0	0	39	39	TT
14	85125287	0	0	41	0	41	GG
14	97239216	0	49	0	0	49	CC
15	52027777	0	31	0	0	31	CC
15	79696701	1	32	0	0	33	CC
15	86123988	27	1	32	1	61	AG
15	86124555	29	0	30	0	59	AG
16	9654056	0	40	0	0	40	CC
17	3480447	0	11	0	16	27	CT
17	28731415	51	0	0	0	51	AA
18	8080357	0	46	0	0	46	CC
18	21495483	0	46	0	0	46	CC
18	23877175	0	45	0	0	45	CC
18	60027241	0	0	0	47	47	TT
19	8968549	15	32	0	0	47	AC
19	20741589	57	0	0	0	57	AA
19	31078219	17	0	34	0	51	AG
19	41869392	0	36	0	0	36	CC
19	51315824	0	0	49	0	49	GG
19	57739247	47	0	1	0	48	AA
2	9796791	42	0	0	0	42	AA
2	49189921	0	0	0	59	59	TT
2	68166080	44	0	21	0	65	AG
2	179871172	19	0	35	0	54	AG
2	182543455	0	29	0	0	29	CC
2	211060050	0	0	0	42	42	TT
2	234601669	0	0	43	15	58	GT
20	4312153	0	0	81	1	82	GG
20	23347553	0	28	0	33	61	CT
20	39797465	0	0	1	42	43	TT
20	40884676	0	48	0	40	88	CT
20	52951047	28	0	36	0	64	AG
21	19842577	0	49	0	0	49	CC
21	43718483	0	0	49	0	49	GG
3	59736584	0	55	0	0	55	CC
3	68434603	0	0	74	0	74	GG
3	80549257	51	0	29	0	80	AG
3	117800545	0	0	30	36	66	GT
3	160534225	0	0	67	1	68	GG
3	183818416	0	0	49	0	49	GG
4	38776491	0	0	24	22	46	GT
4	53219120	0	0	0	59	59	TT
4	60833758	33	0	35	0	68	AG
4	78270033	32	0	36	0	68	AG
4	138313566	1	0	69	1	71	GG
5	8828383	0	0	29	0	29	GG
5	16784873	0	0	0	35	35	TT
5	90151589	0	0	49	0	49	GG
5	112364945	0	0	43	0	43	GG
5	129194264	0	0	38	0	38	GG
6	47708431	67	0	0	0	67	AA
6	159425707	0	0	0	49	49	TT
6	165557550	19	0	30	0	49	AG
7	24213356	0	40	0	48	88	CT
7	45932669	33	0	21	0	54	AG
7	90773196	0	0	0	71	71	TT
8	12957475	0	37	0	0	37	CC
8	23060256	1	19	0	21	41	CT
8	31445496	41	0	28	0	69	AG
8	75822851	58	0	0	0	58	AA
8	77819857	63	0	0	0	63	AA
8	130459412	0	28	1	25	54	CT
9	26531692	34	0	0	0	34	AA
9	32516864	72	0	0	0	72	AA
9	78831415	40	0	26	0	66	AG
9	137828650	0	0	49	0	49	GG
